<SIL>	SIL
<UNK>	UNK
กลับ	kl a p^
กากบาท	k aa k a p aa th^
ขวา	khw aa
ข้าง	kh aa ng^
ซ้าย	s aa j^
ตอบ	t @@ p^
ทอย	th @@ j^
ท่า	th aa
ธรรมดา	th a m^ m a d aa
บน	b o n^
ปุ่ม	p u m^
มา	m aa
รัว	r uua
ลูกเต๋า	l uu k^ t aa w^
ล่าง	l aa ng^
วงกลม	w o ng^ kl o m^
สลับ	s a l a p^
สามเหลี่ยม	s aa m^ l ii m^
สี่เหลี่ยม	s ii l ii m^
หนี	n ii
ออก	z @@ k^
เยอะ	j q
เวทมนต์	w ee t^ m o n^
เหรียญ	r iia n^
โกวาจี	k oo w aa c ii
ใช่	ch a j^
ใช้	ch aa j^
ไป	p a j^
ไม่	m a j^
ไม้ตาย	m aa j^ t aa j^
